111111
101001
100001
100N01
100001