11111111
10000101
10010011
10000001
10001011
10N01111
10001011
11111111